NO ./imgs/wall_n.xpm
SO ./imgs/wall_s.xpm
WE ./imgs/wall_w.xpm
EA ./imgs/wall_e.xpm

F 210,210,210
C 92,209,229

111111
100101
101001
1100N1
111111
