NO ./imgs/wall_n.xpm
SO ./imgs/wall_s.xpm
WE ./imgs/wall_w.xpm
EA ./imgs/wall_e.xpm

F 159,201,60
C 225,30,0

111111111111111111111111111111111
1        1000000000110000000000001
1        1011000001110000000000001
1        1001000000000000000000001
111111111011000001110000000000001
100000000011000001110111111111111
11110111111111011100000010001
11110111111111011101010000001
11000000110101011100000010001
10000000000000000000000010001
10000000000000001101010010001  
11000001110101011111011110N0111
11110111 1110101 101111010001
11111111 1111111 111111111111
