NO ./imgs/wall_n.xpm
SO ./imgs/wall_s.xpm
WE ./imgs/wall_w.xpm
EA ./imgs/wall_e.xpm

F 210,210,210
C 92,209,229

11111111
10000001111
100000000111
100N00000001
1100000000001
1111111111111
